32 30
30
XXXXXXXXXXXXXXXXXXXXXXXXXXXXXXXX
XXXXXXXXXXXXXXXXXXXXXXXXXXXXXXXX
XXXXXXXXXXXXXXXXXXXXXXXXXXXXXXXX
XXOOOXXOOXXXXOXXXXOOOOOOOOOOOOXX
XOOOOOOOOOOOOOOOOOOOOOOOOOOOOOOX
XOOOOOOOOOOOOOOOOOOOOOOOOOOOOOOX
XOOOOXXOOOXXOOOXXOOOXXOOOXXOOOOX
XXOOOXXOOOXXOOOXXOOOXXOOOXXOOOOX
XXOOOXXOOOXXOOOXXOOOXXOOOXXOOOOX
XXOOOOOOOOOOOOOOOOOOOOOOOOOOOOOX
XXOOOOOOOOOOOOOOOOOOOOOOOOOOOOOX
XXOOOOOOOOOOOOOOOOOOOOOOOOOOOOOX
XXOOOXXOOOXXOOOXXOOOXXOOOXXOOOOX
XXOOOXXOOOXXOOOXXOOOXXOOOXXOOOOX
XOOOOXXOOOXXOOOXXOOOXXOOOXXOOOOX
XOOOOOOOOOOOOOOOOOOOOOOOOOOOOOOX
XOOEOOOOEOOOOEOOOOEOOOOEOOOOOOOX
XOOOOOOOOOOOOOOOOOOOOOOOOOOOOOOX
XOOOOOOOOOOOOOOOOOOOOOOOOOOOOOOX
XOOOOOOOOOOOOOOOOOOOOOOOOOOOOOOX
XOOOOOOOOOOOOOOOOOOOOOOOOOOOOOOX
XOOOOOOOOOOOOOOOOOOOOOOOOOOOOOOX
XOOOOOOOOOOOOOOOOOOOOOOOOOOOOOOX
XOOOOOOOOOOOOOOOOOOOOOOOOOOOOOOX
XOOOOOOOOOOOOOOOOOOOOOOOOOOOOOOX
XOOOXOOOOXOOOOXOOOOXOOOOXOOOOOOX
XOOOXOOOOXOOOOXOOOOXOOOOXOOOOOOX
XOOO1YOOO2YOOO3YOOO4YOOO5YOOOOOX
XXOOXOOOOXOOOOXOOOOXOOOOXOOOOOXX
XXXXXXXXXXXXXXXXXXXXXXXXXXXXXXXX