50
XXXXXXXXXXXXXXXXXXXXXXXXX
XOOOOOOOOOOOOOOOOOOOOOOOE
XOOOOOOOOOOOOOOOOOOOOOOOX
XOOOXOOOXOOOXOOOXOOOOOOOX
XOOOXOOOXOOOXOOOXOOOOOOOX
XOOOXOOOXOOOXOOOXOOOOOOOX
XOOOOOOOOOOOOOOOOOOOOOOOX
XOOOOOOOOOOOOOOOOOOOOOOOX
XOOOCOOCOOCOOCOOCOOOOOOOX
XOOOOOOOOOOOOOOOOOOOOOOOX
XOOOOOOOOOOOOOOOOOOOOOOOX
XOOOOOOOOOOOOOOOOOOOOOOOX
XOOOOOOOOOOOOOOOOOOOOOOOX
XOOOOOOOOOOOOOOOOOOOOOOOX
XOOOOOOOOOOOOOOOOOOOOOOOX
XOOOOOOOOOOOOOOOOOOOOOOOX
XOOOOOOOOOOOOOOOOOOOOOOOX
XOOOOOOOOOOOOOOOOOOOOOOOX
XXUXXXXXXXXXXXXXXXXXXXXXX
