XXXXXXXXXXXXXXXXXXXXXXXXX
XOOOOOOOOOOOOOOOOOOOOOOOE
XOOOOOOOOOOOOOOOOOOOOOOOX
XOOOXOOOXOOOXOOOXOOOXOOOX
XOOOXOOOXOOOXOOOXOOOXOOOX
XOOOXOOOXOOOXOOOXOOOXOOOX
XOOOOOOOOOOOOOOOOOOOOOOOX
XOOOOOOOOOOOOOOOOOOOOOOOX
XOOOCOOCOOCOOCOOCOOOOOOOX
XOOOOOOOOOOOOOOOOOOOOOOOX
XOOOOOOOOOOOOOOOOOOOOOOOX
XXUXXXXXXXXXXXXXXXXXXXXXX
