25
XXXXXXXXXXXXXXXXXXXXX
XXXXXXXXXXXXXXXXXXXXX
XXXXXXXXXXXXXXXXXXXXX
XXXXXXXXXXXXXXXXXXXXX
XOOAOOBOOCOODOOEOOOOX
XOOOOOOOOOOOOOOOOOOOX
XOOOOOOOOOOOOOOOOOOOX
XOOOOOOOOOOOOOOOOOOOX
XOOOOOOOOOOOOOOOOOOOX
XOOOOOOOOOOOOOOOOOOOX
XOOOOOOOOOOOOOOOOOOOX
XOOOOOOOOOOOOOOOOOOOX
XOOOOOOOOOOOOOOOOOOOX
XXXO1XO2XO3XO4XO5XXXX
