1 1
map3
XXXXXXXXXXXXXXXXXXXXXXXXX
XXXXXXXXXXXXXXXXXXXXXXXXX
XXXXXXXXXXXXXXXXXXXXXXXXX
XXOXXOOXXXXOXXXXOOOOOOOXX
XOOOOOOOOOOOOOOOOOOOOOOOX
XXOOXXOOOOXXOOOOXXOOOOOOX
XXOOXXOOOOXXOOOOXXOOOOOAX
XXOOXXOOOOXXOOOOXXOOOOOBX
XXOOOOOOOOOOOOOOOOOOOOOOX
XXOOXXOOOOXXOOOOXXOOOOOOX
XXOOXXOOOOXXOOOOXXOOOOOOX
XXOOXXOOOOXXOOOOXXOOOOOOX
XOOOOOOOOOOOOOOOOOOOOOOOX
XOOOOOOOOOOOOOOOOOOOOOOOX
XXOOOOOOOOOOOOOOOOOOOOOOX
XXOOOOOOOOOOOOOOOOOOOOOOX
XXOOOOOOOOOOOOOOOOOOOOOOX
XXOOOOOOOOOOOOOOOOOOOOOOX
XXOOOOOOOOOOOOOOOOOOOOOOX
XXOOOOOOOOOOOOOOOOOOOOOOX
XXOOOOOOOOOOOOOOOOOOOOOOX
XOOOOOOOOOOOOOOOOOOOOOOOX
XOOOOOOOOOOOOOOOOOOOOOOOX
XXOOOOOOOOOOOOOOOOOOOOOOX
XXOOOOOOOOOOOOOOOOOOOOOOX
XXOOOOOOOOOOOOOOOOOOOOOOX
XXOOOOOOOOOOOOOOOOOOOOOOX
XXOOOOOOOOOOOOOOOOOOOOOOX
XXOOOOOOOOOOOOOOOOOOOOOOX
XXOOOOOOOOOOOOOOOOOOOOOOX
XOOOXOOOXOOOXOOOXOOOXOOOX
XOOOXXOOXXOOXXOOXXOOXXOOX
XOOO1XOO2XOO3XOO4XOO5XOOX
XXXOXXOOXXOOXXOOXXOOXXXXX
XXXXXXXXXXXXXXXXXXXXXXXXX
