27 30
25 6
map_snake
XXXXXXXXXXXXXXXXXXXXXXXXXXX
XXXXXXXXXXXXXXXXXXXXXXXXXXX
XXXXXXXXXXXXXXXXXXXXXXXXXXX
XXOOOXXOOXXXXOXXXXOOOOOOOXX
XOOOOOOOOOOOOOOOOOOOOOOOOOX
XOOOOOOOOOOOOOOOOOOOOOOOOOX
XOOOOXXOOOXXOOOXXOOOXXOOOOX
XXOOOXXOOOXXOOOXXOOOXXOOOXX
XXOOOXXOOOXXOOOXXOOOXXOOOXX
XXOOOOOOOOOOOOOOOOOOOOOOOXX
XXOOOOOOOOOOOOOOOOOOOOOOOXX
XXOOOOOOOOOOOOOOOOOOOOOOOXX
XXOOOXXOOOXXOOOXXOOOXXOOOXX
XXOOOXXOOOXXOOOXXOOOXXOOOXX
XOOOOXXOOOXXOOOXXOOOXXOOOOX
XOOAOOOOBOOOOCOOOODOOOOOOOX
XOOOOOOOOOOOOOOOOOOOOOOOOOX
XXOOOOOOOOOOOOOOOOOOOOOOOXX
XXXSXXXXXXXXXXXXXXXXXXXXXXX
XOXOOOOOOOOOOOOOOOOOOOOOXOX
XOXXXXXXXXXXXXXXXXXXXXXOXOX
XXXOOOOOOOOOOOOOOOOOOOOOXXX
XXXZXXXXXXXXXXXXXXXXXXXXXXX
XOOOOOOOOOOOOOOOOOOOOOOOOOX
XOOOOOOOOOOOOOOOOOOOOOOOOOX
XOOOXOOOOXOOOOXOOOOXOOOOOOX
XOOOXOOOOXOOOOXOOOOXOOOOOOX
XOOO1XOOO2XOOO3XOOO4XOOOOOX
XXOOXOOOOXOOOOXOOOOXOOOOOXX
XXXXXXXXXXXXXXXXXXXXXXXXXXX