32 30
30
XXXXXXXXXXXXXXXXXXXXXXXXXXXXXXXX
XXXXXXXXXXXXXXXXXXXXXXXXXXXXXXXX
XXXXXXXXXXXXXXXXXXXXXXXXXXXXXXXX
XXOOOXXOOXXXXOXXXXOOOOOOOOOOOOXX
XOOOOOOOOOOOOOOOOOOOOOOOOOOOOOOX
XOOOOOOOOOOOOOOOOOOOOOOOOOOOOOOX
XOOOOXXOOOXXOOOXXOOOXXOOOXXOOOOX
XXOOOXXOOOXXOOOXXOOOXXOOOXXOOOOX
XXOOOXXOOOXXOOOXXOOOXXOOOXXOOOOX
XXOOOOOOOOOOOOOOOOOOOOOOOOOOOOOX
XXOOOOOOOOOOOOOOOOOOOOOOOOOOOOOX
XXOOOOOOOOOOOOOOOOOOOOOOOOOOOOOX
XXOOOXXOOOXXOOOXXOOOXXOOOXXOOOOX
XXOOOXXOOOXXOOOXXOOOXXOOOXXOOOOX
XOOOOXXOOOXXOOOXXOOOXXOOOXXOOOOX
XOOOOOOOOOOOOOOOOOOOOOOOOOOOOOOX
XOOAOOOOBOOOOCOOOODOOOOEOOOOOOOX
XOOOOOOOOOOOOOOOOOOOOOOOOOOOOOOX
XXOSXXXXXXXXXXXXXXXXXXXXXXXXXXXX
XXOOOOOOOOOOOOOOOOOOOOOOOOOOOOXX
XXXXXXXXXXXXXXXXXXXXXXXXXXXXZOXX
XXOOOOOOOOOOOOOOOOOOOOOOOOOOOOXX
XXOOOOOOOOOOOOOOOOOOOOOOOOOOOOXX
XOOOOOOOOOOOOOOOOOOOOOOOOOOOOOOX
XOOOOOOOOOOOOOOOOOOOOOOOOOOOOOOX
XOOOXOOOOXOOOOXOOOOXOOOOXXXXXXXX
XOOOXOOOOXOOOOXOOOOXOOOOXOOOOOOX
XOOO1YOOO2YOOO3YOOO4YOOO5YOOOOOX
XXOOXOOOOXOOOOXOOOOXOOOOXOOOOOXX
XXXXXXXXXXXXXXXXXXXXXXXXXXXXXXXX